********************
*X*X*X*XXX*XXXX**X*X
***X*X***X*****X*X*X
*XXXXXXXXXXX*X*XXXXX
***********X*X*****X
*X*X*X*XXXXX*X*X*XXX
*X*X*X*****X*X*****X
*XXX*X*X*X*X*X*X*XXX
***X*X*X*X*X*X*X***X
*XXXXXXX***X*XXXXX*X
*******X*X*X*****X*X
*XXX*XXX*X*X**XX*XXX
***X***X*X*X***X***X
*XXX*X*X*XXX*X*XXXXX
***X*X*X***X*X*****X
*XXX*XXX*XXX*XXXXX*X
***X***X***X*****X*X
*XXXXX*XXX*X*XXXXX*X
*****X***X*X*****X*X
*XXXXXXXXXXXXXXXXX**